R 700 700
F 74,63,255
C 200,200,252
NO textures/pokeball_n.xpm
WE textures/pokeball_n.xpm
S textures/pokeball_n.xpm





EA textures/pokeball_n.xpm
SO textures/pokeball_n.xpm


11111111111111111111111
10100000000000010110001
10011000000000201110101
10000000000000000000101
10000000000200000000001
10000000000110000000001111
100000000000000000000011
10000000000000000000011
100000000000000000000011
10000000000200000000001
10000000000000000000011
100E000000000000000111
10011000110000010001111
11111111111111111111
