R 801 600
F 74,63,255
C 200,200,252

NO textures/bluestone.png
SO textures/redbrick.png
WE textures/colorstone.png
EA textures/eagle.xpm

S textures/pillar.png

   11111111111111111111111111111
   11000000000000000000000110001
   10110000000000000000001110001
   10200000000000000000000010001
11110000000000000000000000010111
100000000000000000000000000101
100000000000000000000000000001
100000000000000000000000000001
100000000000000001110000000001111
1000000000000000000000000000011
11100000000000000000000000000011
  102000200000000000000000000011
  10000000000000202000000000001
1110000000000000000000000000011
120000000000000000000000000001
100000000000202000000000000011
100000N0000000000000111000111
100011000000110000001 10001111
111111111111111111111 11111
