R 666 666
F 74,63,255
C 200,200,255
NO textures/pokeball_n.xpm
WE textures/pokeball_n.xpm
S textures/pokeball_n.xpm




EA textures/pokeball_n.xpm
SO textures/pokeball_n.xpm


1111111111111111
10000100000000011111
10200S01111110000001
10102001000000011111
1111111111111111
