R 800 600
F 74,63,255
C 200,200,252

NO textures/bluestone.png
SO textures/redbrick.png
WE textures/colorstone.png
EA textures/eagle.xpm

S textures/pillar.png



11111111111111111111111111
10100000000000000010110001
10011000000000000001110001
10000000000000000000011101
10000000000000000000000101
10000000000000000000000001
10000000000000000000000001
10000000000001110000000001111
100000000000000000000000011
10000000000000000000000011
100000000020200000000000011
10020000000000000000000001
10000000002020000000000011
100N000000000000000000111
10011000001100000010001111
11111111111111111111111
