R 750 750
F 74,63,255
C 200,200,252

NO textures/bluestone.png
SO textures/redbrick.png
WE textures/colorstone.png
EA textures/eagle.png

S textures/pillar.png



11111111111111111111111111
12100000000000000010112001
10011000000000000001110001
10000000000000000000011101
10000000000000000000000101
10000000000000000000000001
10000000000000200000000001
10000000000001110000000001111
100000000000000000000002011
10000000000000000000000011
102000000000000000000000011
10000000000002000000000001
10000000000000000000000011
100N000000000000000000111
10011000001100000010001111
11111111111111111111111
