R 640 480

NO ./textures/bluestone.png
WE ./textures/eagle.xpm
SO ./textures/redbrick.png
EA ./textures/colorstone.png
C 222,92,92
F 170,170,1
S ./textures/barrel.png

    11111111111111111111
111110000000000000000001
100000000000000000000001
100000000000000000000001
100000111110000101010001
100000100010000000000001
100000100010000101010001
100000100010000000000001
100000110110000101010001
100000000000000000000001
102020200000000000000001
100000000000000000000001
102020200000000000000001
100000000000000000000001
102020200000000000000001
100000000000000000000001
111111111000000000000001
110100001000000000000201
110000001000000000000001
11010000100000000N000201
110111111000000000000001
110000000000000000000201
111111111000000000000001
        1111111111111111
